barcode	seq	rev
barcode_1	GTACCTGACTCTATATTATATTTTT	AAAAATATAATATAGAGTCAGGTAC
barcode_2	TTTTGTCATCGCTCGGTTTCAAAAT	ATTTTGAAACCGAGCGATGACAAAA
barcode_4	TATCTATTTACTACCGTCACTCGTC	GACGAGTGACGGTAGTAAATAGATA
barcode_5	ATTTAGGTAACAATATTTTCATACC	GGTATGAAAATATTGTTACCTAAAT
barcode_6	ACATTGTTTTTGATGGAAGCGCCTT	AAGGCGCTTCCATCAAAAACAATGT
barcode_9	ATACCTGCCCTCACACGTGCATCAC	GTGATGCACGTGTGAGGGCAGGTAT
barcode_10	GGATAAGCCTACGACTTATTTATAC	GTATAAATAAGTCGTAGGCTTATCC
barcode_11	TTTGTTTCTTTTCATTTCCTTAGC	GCTAAGGAAATGAAAAGAAACAAA
barcode_12	GTACTATAGTGTAGTTGTTACTAGT	ACTAGTAACAACTACACTATAGTAC
barcode_13	TTAATATTCCGGAGTAGGTTCGATA	TATCGAACCTACTCCGGAATATTAA
barcode_14	TCGCGAGTCCGCCTTTCCAGCACC	GGTGCTGGAAAGGCGGACTCGCGA
barcode_15	AATCTATAATTATATATGGACCTCT	AGAGGTCCATATATAATTATAGATT
barcode_16_6	CTGCTCTTACTCTGATCATTGGGTT	AACCCAATGATCAGAGTAAGAGCAG
barcode_17	GTGGCTGCTTCTTGATGGGGGGGTC	GACCCCCCCATCAAGAAGCAGCCAC
barcode_18	ATGGCGAATTTATTTGCGCGTTTAC	GTAAACGCGCAAATAAATTCGCCAT
barcode_21_11	CTATTTGTAATTATGATGCTTCATG	CATGAAGCATCATAATTACAAATAG
barcode_22	CACTATGCTTAAGCACATTCAATTA	TAATTGAATGTGCTTAAGCATAGTG
barcode_23	GTTGATTCTCTCCCTATCGCCATTA	TAATGGCGATAGGGAGAGAATCAAC
barcode_24	TTGTGCTTTACATATTGCAATTTTT	AAAAATTGCAATATGTAAAGCACAA
barcode_25	ATAAGCATTCTTACTGCCGTCTCTA	TAGAGACGGCAGTAAGAATGCTTAT
barcode_26	ATGGCATCTTAGTTCCCAGTAGTTG	CAACTACTGGGAACTAAGATGCCAT
barcode_27	TTGCTGCTTATACGTTTTTTCAGGG	CCCTGAAAAAACGTATAAGCAGCAA
barcode_28	TCTATTCTTGATGTCTACATCACCT	AGGTGATGTAGACATCAAGAATAGA
barcode_29	TTGGCACAAAAACTTTGTGATGTCAC	GTGACATCACAAAGTTTTTGTGCCAA
barcode_30	TATAAATCGTTCTCCTCGGTAGATG	CATCTACCGAGGAGAACGATTTATA
barcode_31	ATTATCCTTGAGTGTGAAGCATTAT	ATAATGCTTCACACTCAAGGATAAT